या	य ा |
चार	च ा र |
पैंसठ	प ै ं स ठ |
पाकिस्तान	प ा क ि स ् त ा न |
उतनी	उ त न ी |
गोपनीयता	ग ो प न ी य त ा |
काम	क ा म |
लेते	ल े त े |
रहा	र ह ा |
भी	भ ी |
(शिखा)	( श ि ख ा ) |
उच्च	उ च ् च |
लगातार	ल ग ा त ा र |
रहता	र ह त ा |
होता	ह ो त ा |
पर	प र |
महाराष्ट्र	म ह ा र ा ष ् ट ् र |
बढ़ती	ब ढ़ त ी |
प्रधानमंत्री	प ् र ध ा न म ं त ् र ी |
संदिग्ध	स ं द ि ग ् ध |
जाता	ज ा त ा |
उस	उ स |
नहीं	न ह ी ं |
अच्छा	अ च ् छ ा |
जारी	ज ा र ी |
द्वारा	द ् व ा र ा |
दिलाई.	द ि ल ा ई . |
अभूतपूर्व	अ भ ू त प ू र ् व |
यह	य ह |
दिन	द ि न |
पीछे	प ी छ े |
प्रस्ताव	प ् र स ् त ा व |
दिनों	द ि न ो ं |
देश	द े श |
प्रमुख	प ् र म ु ख |
एक	ए क |
राहतभरी	र ा ह त भ र ी |
यमराज	य म र ा ज |
है,	ह ै , |
किया	क ि य ा |
हुए	ह ु ए |
सिंह	स ि ं ह |
भेज	भ े ज |
जगह	ज ग ह |
अगले	अ ग ल े |
कहर	क ह र |
कोरोना	क ो र ो न ा |
मामले	म ा म ल े |
फैसला	फ ै स ल ा |
गलत	ग ल त |
पुलिस	प ु ल ि स |
22वें	2 2 व े ं |
साथ	स ा थ |
छोटी-सी	छ ो ट ी - स ी |
खबर	ख ब र |
है	ह ै |
कई	क ई |
इमरान	इ म र ा न |
गए	ग ए |
उन्होंने	उ न ् ह ो ं न े |
अदालत	अ द ा ल त |
कहा	क ह ा |
शनिवार	श न ि व ा र |
कुछ	क ु छ |
हुसैन	ह ु स ै न |
उर्दू	उ र ् द ू |
रिमांड	र ि म ा ं ड |
इसके	इ स क े |
अटके,	अ ट क े , |
राष्ट्रपति	र ा ष ् ट ् र प त ि |
का	क ा |
भवन	भ व न |
आज	आ ज |
रखना	र ख न ा |
पद	प द |
गैरजिम्मेदाराना	ग ै र ज ि म ् म े द ा र ा न ा |
कि	क ि |
आईआरएस	आ ई आ र ए स |
शब्दों	श ब ् द ो ं |
दायर	द ा य र |
भगत	भ ग त |
कंपनियों	क ं प न ि य ो ं |
को	क ो |
ऐवान-ए-सद्र	ऐ व ा न - ए - स द ् र |
मुंडन	म ु ं ड न |
शब्द	श ब ् द |
उच्चारण	उ च ् च ा र ण |
लेकिन	ल े क ि न |
शीतल	श ी त ल |
दिया।	द ि य ा । |
रूप	र ू प |
और	औ र |
जबकि	ज ब क ि |
संघ	स ं घ |
किए	क ि ए |
कर	क र |
समय	स म य |
पिछले	प ि छ ल े |
की	क ी |
सिर	स ि र |
आरोप	आ र ो प |
चोरी	च ो र ी |
से	स े |
जीएसटी.	ज ी ए स ट ी . |
पढ़े.	प ढ ़ े . |
न्यायाधीश	न ् य ा य ा ध ी श |
ढंग	ढ ं ग |
अपने	अ प न े |
लिए	ल ि ए |
पा	प ा |
दाैरान	द ा ै र ा न |
ने	न े |
तहरीक-ए-इंसाफ	त ह र ी क - ए - इ ं स ा फ |
ही	ह ी |
नजर	न ज र |
सकी,	स क ी , |
खबरों	ख ब र ो ं |
न्यायालय	न ् य ा य ा ल य |
वर्षीय	व र ् ष ी य |
है।	ह ै । |
माना	म ा न ा |
तर्क	त र ् क |
बुद्धिमत्ता	ब ु द ् ध ि म त ् त ा |
आशु	आ श ु |
कोश्यारी	क ो श ् य ा र ी |
जितनी	ज ि त न ी |
कम	क म |
वायरस	व ा य र स |
इससे	इ स स े |
दिया	द ि य ा |
शपथ	श प थ |
आ	आ |
राज्यपाल	र ा ज ् य प ा ल |
में	म े ं |
पक्ष	प क ् ष |
ममनून	म म न ू न |
चोटी	च ो ट ी |
सुना	स ु न ा |
संगठन	स ं ग ठ न |
खान	ख ा न |
मस्तिष्क	म स ् त ि ष ् क |
एकाग्रता	ए क ा ग ् र त ा |
के	क े |
लगाया	ल ग ा य ा |
